111111111111111111111111
1P00000000000000000000C1
10000C000010001110C00001
10000C000100010010C00001
10000C001000000010C00001
10000C011110001100C00001
10000C000010010000C00001
10000C000010010010C00001
10000C000010011100C00001
1000000000000000000000E1
111111111111111111111111