111111
10P1E1
101101
101101
10IIC1
111111